14,1,8,0,15,0,0,0,0,0,16
1,1,7,0,0,0,0,0,0,15,15
9,7,0,0,0,0,0,0,0,0,15
0,0,0,0,0,0,0,0,0,0,0
0,15,15,0,0,0,0,0,0,0,0
0,15,15,0,0,0,0,0,0,0,0
15,15,0,16,0,0,0,16,0,0,0
15,0,0,0,0,0,0,0,0,0,0
0,0,0,0,0,0,0,0,0,0,0
0,0,15,0,0,0,0,0,15,0,0
16,0,15,15,0,0,0,0,0,0,16
